{
	"numX": 13,
	"numY": 9,
	"size": [64, 64],
	"start": [32, 32],
	"tileNames": ["", "Tile01", "Tile02", "ProtoCoin", "ProtoBox", "ProtoBat"],
	"tiles": [0, 0, 0, 0, 0, 0, 0, 0, 0, 0, 0, 0, 0,
		      0, 5, 0, 0, 0, 0, 0, 0, 0, 0, 0, 5, 0,
		      0, 0, 0, 0, 0, 0, 0, 0, 0, 0, 0, 0, 0,
		      0, 0, 0, 0, 0, 0, 0, 0, 0, 0, 0, 0, 0,
		      0, 3, 3, 0, 0, 0, 0, 0, 0, 0, 3, 3, 0,
		      0, 1, 1, 0, 0, 0, 0, 0, 0, 0, 1, 1, 0,
		      1, 0, 0, 4, 0, 0, 0, 0, 0, 4, 0, 0, 1,
		      1, 0, 0, 4, 0, 0, 0, 0, 0, 4, 0, 0, 1,
			  1, 1, 1, 1, 1, 1, 1, 1, 1, 1, 1, 1, 1]
			  
}
